ads-latingrammys	ads (latin grammys)
ads-lung-health	ads (lung health)
advice	advice
animals	animals
autosbuying	autos (buying)
autoscartech	autos (car tech)
autosclassics	autos (classics)
autoscompact	autos (compact)
autosconvertibles	autos (convertibles)
autosenthusiasts	autos (enthusiasts)
autoshybrids	autos (hybrids)
autoslosangeles	autos (los angeles)
autosluxury	autos (luxury)
autosmidsize	autos (midsize)
autosmotorcycles	autos (motorcycles)
autosnews	autos (news)
autosownership	autos (ownership)
autospassenger	autos (passenger)
autosresearch	autos (research)
autosresearchguides	autos (research guides)
autosreview	autos (review)
autossema	autos (sema)
autossports	autos (sports)
autossuvs	autos (suvs)
autostokyo	autos (tokyo)
autostrucks	autos (trucks)
autosvans	autos (vans)
autosvideonew	autos (videos)
autosvideos	autos (videos)
awards	awards
awardstyle	award style
baseball	baseball
baseball_mlb	baseball (mlb)
baseball_mlb_videos	baseball (mlb videos)
basketball	basketball
basketball_nba	basketball (nba)
basketball_nba_videos	basketball (nba videos)
basketball_ncaa	basketball (ncaa)
basketball_ncaa_videos	basketball (ncaa vidieos)
basketball_wnba	basketball (wnba)
beverages	beverages
boxing	boxing
boxing-mma	boxing (mma)
cardio	cardio
career-news	career (news)
causes	causes
causes-animals	causes (animals)
causes-disaster-relief	causes (disaster relief)
causes-environment	causes (environment)
causes-food-insecurity	causes (animals)
causes-gender-equality	causes (gender equality)
causes-green-living	causes (green living)
causes-military-appreciation	causes (military appreciation)
causes-poverty	causes (poverty)
celebhub	celebhub
celebrity	celebrity
celebritynews	celebrity news
cma-awards	cma awards
cocktails	cocktails
comedy	comedy
company-news	company news
cooking	cooking
cookingschool	cooking school
downtime	downtime
elections-2020-us	elections 2020 us
empowering-the-planet	empowering the planet
entertainment-books	entertainment books
entertainment-celebrity	entertainment celebrity
entertainmentmusic	entertainment music
entertainmenttv	entertainmenttv
factcheck	fact check
familyhealth	family health
finance-auto-insurance	finance (auto insurance)
finance-billstopay	finance (bills to pay)
finance-career	finance (career)
finance-career-education	finance (career education)
finance-companies	finance (companies)
finance-credit	finance (credit)
finance-education	finance (education)
finance-healthcare	finance (healthcare)
finance-home-loans	finance (home loans)
finance-homesandpropertysection	finance (homes and property section)
finance-insidetheticker	finance (inside the ticker)
finance-insurance	finance (insurance)
finance-mutual-funds	finance (mutual funds)
finance-real-estate	finance (real estate)
finance-retirement	finance (retirement)
finance-savemoney	finance (save money)
finance-saving-investing	finance (saving investing)
finance-savingsrates	finance (savings rates)
finance-small-business	finance (small business)
finance-startinvesting	finance (start investing)
finance-taxes	finance (taxes)
finance-technology	finance (technology)
finance-top-stocks	finance (top stocks)
finance-video	finance (video)
financenews	finance (news)
fitness	fitness
foodanddrink	food and drink
foodnews	food (news)
foodrecipes	food (recipes)
foodtips	food (tips)
foodvideos	food (videos)
football_ncaa	football (ncaa)
football_ncaa_videos	football (ncaa videos)
football_nfl	Football (nfl)
football_nfl_videos	Football (nfl videos)
fun	fun
games	games
games-news	Games (news)
gaming	gaming
golf	golf
golfvideos	golf (videos)
grammys-video	Grammys (video)
halloween	halloween
health-cancer	health (cancer)
health-news	health (news)
healthagingwell	health (aging well)
healthandfitness	health and fitness
healthnews	health (news)
healthtrending	health (trending)
healthyliving	healthy living
holidays	holidays
hollywood	hollywood
humor	humor
icehockey_nhl	ice hockey (nhl)
indepth	in depth
internationaltravel	international travel
lifestyle	lifestyle
lifestyle-news-feature	lifestyle (news feature)
lifestyle-wedding	lifestyle (wedding)
lifestyleanimals	lifestyle (animals)
lifestylebeauty	lifestyle (beauty)
lifestylebuzz	lifestyle (buzz)
lifestylecareer	lifestyle (career)
lifestylecelebstyle	lifestyle (celeb style)
lifestylecleaningandorganizing	lifestyle (cleaning and organizing)
lifestyledecor	lifestyle (d√©cor)
lifestyledesign	lifestyle (design)
lifestyledidyouknow	lifestyle (did you know)
lifestylediy	lifestyle (diy)
lifestylefamily	lifestyle (family)
lifestylefamilyandrelationships	lifestyle (family and relationships)
lifestylefashion	lifestyle (fashion)
lifestylehomeandgarden	lifestyle (home and garden)
lifestylehoroscope	lifestyle (horoscope)
lifestylehoroscopefish	lifestyle (horoscope)
lifestylelovesex	lifestyle (love sex)
lifestylemarriage	lifestyle (marriage)
lifestylemindandsoul	lifestyle (mind and soul)
lifestyleparenting	lifestyle (parenting)
lifestylepets	lifestyle (pets)
lifestylepetsanimals	lifestyle (pets)
lifestylerelationships	lifestyle (relationships)
lifestyleroyals	lifestyle (royals)
lifestyleshopping	lifestyle (shopping)
lifestyleshoppinghomegarden	lifestyle (shopping home garden)
lifestylesmartliving	lifestyles (mart living)
lifestylestyle	lifestyle (style)
lifestyletravel	lifestyle (travel)
lifestylevideo	lifestyle (video)
lifestyleweddings	lifestyle (weddings)
lifestylewhatshot	lifestyle (whats hot)
localnews	local news
markets	markets
medical	medical
mentalhealth	mental health
middleeast-top-stories	middle east top stories
mindandbody	mind and body
mma	mma
mmaufc	mma
more_sports	more sports
movienews	movie (news)
movies-awards	movies (awards)
movies-celebrity	movies (celebrity)
movies-gallery	movies (gallery)
movies-oscars	movies (oscars)
movievideo	movie (video)
music-awards	music (awards)
music-celebrity	music (celebrity)
music-gallery	music (gallery)
music-grammys	music (grammys)
music-reviews	music (reviews)
musicnews	music (news)
musicvideos	music (videos)
narendramodi_opinion	narendra modi opinion
news	news
newsbusiness	news (business)
newscrime	news (crime)
newselection2020	news (election 2020)
newsfactcheck	news (fact check)
newsgoodnews	news (good news)
newslocalpolitics	news (local politics)
newsnational	news (national)
newsoffbeat	news (offbeat)
newsopinion	news (opinion)
newsother	news (other)
newsphotos	news (photos)
newspolitics	news (politics)
newsrealestate	news (real estate)
newsscience	news (science and technology)
newsscienceandtechnology	news (science and technology)
newstechnology	news (science and technology)
newstrends	news (trends)
newstvmedia	news (tv media)
newsus	news us
newsvideo	news (video)
newsvideos	news (video)
newsweather	news (weather)
newsworld	news (world)
newsworldpolitics	news (world politics)
northamerica-video	north america (videos)
nutrition	nutrition
olympics-videos	olympics (videos)
opinion-polls	opinion (polls)
other	other
othersports	other (sports)
outdoors	outdoors
people-places	people (places)
peopleandplaces	people and places
personalfinance	personal finance
photos	photos
popculture	pop culture
pregnancyparenting	pregnancy (parenting)
quickandeasy	quick and easy
racing	racing
recipes	recipes
relationships	relationships
restaurantsandnews	restaurants and news
retirement	retirement
reviews	reviews
science	science
seasonal	seasonal
seasonalvideos	seasonal (videos)
shop-all	shop (all)
shop-apparel	shop (apparel)
shop-books-movies-tv	shop (books, movies, and tv)
shop-computers-electronics	shop (computers, electronics)
shop-holidays	shop (holidays)
shop-home-goods	shop (home goods)
shop-toys	shop (toys)
smartliving	smart living
soccer	soccer
soccer_bund	soccer (bund)
soccer_epl	soccer (epl)
soccer_fifa_wwc	soccer (fifa wwc)
soccer_mls	soccer (mls)
soccer_videos	soccer (videos)
spendingandborrowing	spending and borrowing
sports	sports
sports_news	sports (news)
strength	strength
style	style
technology	technology
technologyinvesting	technology investing
tennis	tennis
tennis_intl	tennis (intl)
tipsandtricks	tips and tricks
topnews	top news
travel	travel
travel-accessible	travel (accessible)
travel-adventure-travel	travel (adventure travel)
travel-points-rewards	travel (points rewards)
travel-videos	travel (videos)
travelarticle	travel (article)
travelnews	travel (news)
traveltips	travel (tips)
traveltripideas	travel (trip ideas)
traveltrivia	travel (trivia)
tunedin	tuned in
tv	tv
tv-celebrity	tv (celebrity)
tv-gallery	tv (gallery)
tv-golden-globes	tv (golden globes)
tv-golden-globes-video	tv (golden globes video)
tv-recaps	tv (recaps)
tv-reviews	tv (reviews)
tvnews	tv (news)
tvvideos	tv (videos)
ustravel	us travel
video	videos
videos	videos
viral	viral
voices	voices
watch	watch
weatherfullscreenmaps	weather (full screen maps)
weathertopstories	weather (top stories)
weight-loss	weight loss
weightloss	weight loss
wellness	wellness
wines	wines
wonder	wonder
yearinoffbeatgoodnews	year in offbeat goodnews
